000000000000000
022222222222220
021111111111120
022211111111220
022221111112220
022222111122220
022222211222220
022222232222220
000000000000000
000000000000000